Rep	State
1. Bradley Byrne (R)	AL
2. Martha Roby (R)	AL
3. Mike Rogers (R)	AL
4. Robert Aderholt (R)	AL
5. Mo Brooks (R)	AL
6. Gary Palmer (R)	AL
7. Terri Sewell (D)	AL
At-large. Don Young (R)	AK
1. Ann Kirkpatrick (D)	AZ
2. Martha McSally (R)	AZ
3. Raúl Grijalva (D)	AZ
4. Paul Gosar (R)	AZ
5. Matt Salmon (R)	AZ
6. David Schweikert (R)	AZ
7. Ruben Gallego (D)	AZ
8. Trent Franks (R)	AZ
9. Kyrsten Sinema (D)	AZ
1. Rick Crawford (R)	AR
2. French Hill (R)	AR
3. Steve Womack (R)	AR
4. Bruce Westerman (R)	AR
1. Doug LaMalfa (R)	CA
2. Jared Huffman (D)	CA
3. John Garamendi (D)	CA
4. Tom McClintock (R)	CA
5. Mike Thompson (D)	CA
6. Doris Matsui (D)	CA
7. Ami Bera (D)	CA
8. Paul Cook (R)	CA
9. Jerry McNerney (D)	CA
10. Jeff Denham (R)	CA
11. Mark DeSaulnier (D)	CA
12. Nancy Pelosi (D)	CA
13. Barbara Lee (D)	CA
14. Jackie Speier (D)	CA
15. Eric Swalwell (D)	CA
16. Jim Costa (D)	CA
17. Mike Honda (D)	CA
18. Anna Eshoo (D)	CA
19. Zoe Lofgren (D)	CA
20. Sam Farr (D)	CA
21. David Valadao (R)	CA
22. Devin Nunes (R)	CA
23. Kevin McCarthy (R)	CA
24. Lois Capps (D)	CA
25. Steve Knight (R)	CA
26. Julia Brownley (D)	CA
27. Judy Chu (D)	CA
28. Adam Schiff (D)	CA
29. Tony Cardenas (D)	CA
30. Brad Sherman (D)	CA
31. Pete Aguilar (D)	CA
32. Grace Napolitano (D)	CA
33. Ted Lieu (D)	CA
34. Xavier Becerra (D)	CA
35. Norma Torres (D)	CA
36. Raul Ruiz (D)	CA
37. Karen Bass (D)	CA
38. Linda Sánchez (D)	CA
39. Ed Royce (R)	CA
40. Lucille Roybal-Allard (D)	CA
41. Mark Takano (D)	CA
42. Ken Calvert (R)	CA
43. Maxine Waters (D)	CA
44. Janice Hahn (D)	CA
45. Mimi Walters (R)	CA
46. Loretta Sanchez (D)	CA
47. Alan Lowenthal (D)	CA
48. Dana Rohrabacher (R)	CA
49. Darrell Issa (R)	CA
50. Duncan Hunter (R)	CA
51. Juan Vargas (D)	CA
52. Scott Peters (D)	CA
53. Susan Davis (D)	CA
1. Diana DeGette (D)	CO
2. Jared Polis (D)	CO
3. Scott Tipton (R)	CO
4. Ken Buck (R)	CO
5. Doug Lamborn (R)	CO
6. Mike Coffman (R)	CO
7. Ed Perlmutter (D)	CO
1. John Larson (D)	CT
2. Joe Courtney (D)	CT
3. Rosa DeLauro (D)	CT
4. Jim Himes (D)	CT
5. Elizabeth Esty (D)	CT
At-large. John Carney (D)	DE
1. Jeff Miller (R)	FL
2. Gwen Graham (D)	FL
3. Ted Yoho (R)	FL
4. Ander Crenshaw (R)	FL
5. Corrine Brown (D)	FL
6. Ron DeSantis (R)	FL
7. John Mica (R)	FL
8. Bill Posey (R)	FL
9. Alan Grayson (D)	FL
10. Daniel Webster (R)	FL
11. Rich Nugent (R)	FL
12. Gus Bilirakis (R)	FL
13. David Jolly (R)	FL
14. Kathy Castor (D)	FL
15. Dennis Ross (R)	FL
16. Vern Buchanan (R)	FL
17. Tom Rooney (R)	FL
18. Patrick Murphy (D)	FL
19. Curt Clawson (R)	FL
20. Alcee Hastings (D)	FL
21. Ted Deutch (D)	FL
22. Lois Frankel (D)	FL
23. Debbie Wasserman Schultz (D)	FL
24. Frederica Wilson (D)	FL
25. Mario Diaz-Balart (R)	FL
26. Carlos Curbelo (R)	FL
27. Ileana Ros-Lehtinen (R)	FL
1. Buddy Carter (R)	GA
2. Sanford Bishop (D)	GA
3. Lynn Westmoreland (R)	GA
4. Hank Johnson (D)	GA
5. John Lewis (D)	GA
6. Tom Price (R)	GA
7. Rob Woodall (R)	GA
8. Austin Scott (R)	GA
9. Doug Collins (R)	GA
10. Jody Hice (R)	GA
11. Barry Loudermilk (R)	GA
12. Rick Allen (R)	GA
13. David Scott (D)	GA
14. Tom Graves (R)	GA
1. Colleen Hanabusa (D)	HI
2. Tulsi Gabbard (D)	HI
1. Raul Labrador (R)	ID
2. Mike Simpson (R)	ID
1. Bobby Rush (D)	IL
2. Robin Kelly (D)	IL
3. Dan Lipinski (D)	IL
4. Luis Gutiérrez (D)	IL
5. Mike Quigley (D)	IL
6. Peter Roskam (R)	IL
7. Danny Davis (D)	IL
8. Tammy Duckworth (D)	IL
9. Jan Schakowsky (D)	IL
10. Robert Dold (R)	IL
11. Bill Foster (D)	IL
12. Mike Bost (R)	IL
13. Rodney Davis (R)	IL
14. Randy Hultgren (R)	IL
15. John Shimkus (R)	IL
16. Adam Kinzinger (R)	IL
17. Cheri Bustos (D)	IL
18. Darin LaHood (R) IL
1. Pete Visclosky (D)	IN
2. Jackie Walorski (R)	IN
3. Marlin Stutzman (R)	IN
4. Todd Rokita (R)	IN
5. Susan Brooks (R)	IN
6. Luke Messer (R)	IN
7. André Carson (D)	IN
8. Larry Bucshon (R)	IN
9. Todd Young (R)	IN
1. Rod Blum (R)	IA
2. David Loebsack (D)	IA
3. David Young (R)	IA
4. Steve King (R)	IA
1. Tim Huelskamp (R)	KS
2. Lynn Jenkins (R)	KS
3. Kevin Yoder (R)	KS
4. Mike Pompeo (R)	KS
1. Ed Whitfield (R) KY
2. Brett Guthrie (R)	KY
3. John Yarmuth (D)	KY
4. Thomas Massie (R)	KY
5. Hal Rogers (R)	KY
6. Andy Barr (R)	KY
1. Steve Scalise (R)	LA
2. Cedric Richmond (D)	LA
3. Charles Boustany (R)	LA
4. John Fleming (R)	LA
5. Ralph Abraham (R)	LA
6. Garret Graves (R)	LA
1. Chellie Pingree (D)	ME
2. Bruce Poliquin (R)	ME
1. Andy Harris (R)	MD
2. Dutch Ruppersberger (D)	MD
3. John Sarbanes (D)	MD
4. Donna Edwards (D)	MD
5. Steny Hoyer (D)	MD
6. John Delaney (D)	MD
7. Elijah Cummings (D)	MD
8. Chris Van Hollen (D)	MD
1. Richard Neal (D)	MA
2. Jim McGovern (D)	MA
3. Niki Tsongas (D)	MA
4. Joe Kennedy (D)	MA
5. Katherine Clark (D)	MA
6. Seth Moulton (D)	MA
7. Mike Capuano (D)	MA
8. Stephen Lynch (D)	MA
9. Bill Keating (D)	MA
1. Dan Benishek (R)	MI
2. Bill Huizenga (R)	MI
3. Justin Amash (R)	MI
4. John Moolenaar (R)	MI
5. Dan Kildee (D)	MI
6. Fred Upton (R)	MI
7. Tim Walberg (R)	MI
8. Mike Bishop (R)	MI
9. Sander Levin (D)	MI
10. Candice Miller (R)	MI
11. Dave Trott (R)	MI
12. Debbie Dingell (D)	MI
13. John Conyers (D)	MI
14. Brenda Lawrence (D)	MI
1. Tim Walz (D)	MN
2. John Kline (R)	MN
3. Erik Paulsen (R)	MN
4. Betty McCollum (D)	MN
5. Keith Ellison (D)	MN
6. Tom Emmer (R)	MN
7. Collin Peterson (D)	MN
8. Rick Nolan (D)	MN
1. Trent Kelly (R)	MS
2. Bennie Thompson (D)	MS
3. Gregg Harper (R)	MS
4. Steven Palazzo (R)	MS
1. Lacy Clay (D)	MO
2. Ann Wagner (R)	MO
3. Blaine Luetkemeyer (R)	MO
4. Vicky Hartzler (R)	MO
5. Emanuel Cleaver (D)	MO
6. Sam Graves (R)	MO
7. Billy Long (R)	MO
8. Jason Smith (R)	MO
At-large. Ryan Zinke (R)	MT
1. Jeff Fortenberry (R)	NE
2. Brad Ashford (D)	NE
3. Adrian Smith (R)	NE
1. Dina Titus (D)	NV
2. Mark Amodei (R)	NV
3. Joe Heck (R)	NV
4. Cresent Hardy (R)	NV
1. Frank Guinta (R)	NH
2. Ann McLane Kuster (D)	NH
1. Donald Norcross (D)	NJ
2. Frank LoBiondo (R)	NJ
3. Tom MacArthur (R)	NJ
4. Chris Smith (R)	NJ
5. Scott Garrett (R)	NJ
6. Frank Pallone (D)	NJ
7. Leonard Lance (R)	NJ
8. Albio Sires (D)	NJ
9. Bill Pascrell (D)	NJ
10. Donald Payne (D)	NJ
11. Rodney Frelinghuysen (R)	NJ
12. Bonnie Watson Coleman (D)	NJ
1. Michelle Lujan Grisham (D)	NM
2. Steve Pearce (R)	NM
3. Ben Ray Luján (D)	NM
1. Lee Zeldin (R)	NY
2. Peter King (R)	NY
3. Steve Israel (D)	NY
4. Kathleen Rice (D)	NY
5. Gregory Meeks (D)	NY
6. Grace Meng (D)	NY
7. Nydia Velázquez (D)	NY
8. Hakeem Jeffries (D)	NY
9. Yvette Clarke (D)	NY
10. Jerrold Nadler (D)	NY
11. Daniel Donovan (R)	NY
12. Carolyn Maloney (D)	NY
13. Charles Rangel (D)	NY
14. Joseph Crowley (D)	NY
15. José E. Serrano (D)	NY
16. Eliot Engel (D)	NY
17. Nita Lowey (D)	NY
18. Sean Patrick Maloney (D)	NY
19. Chris Gibson (R)	NY
20. Paul Tonko (D)	NY
21. Elise Stefanik (R)	NY
22. Richard Hanna (R)	NY
23. Thomas Reed (R)	NY
24. John Katko (R)	NY
25. Louise Slaughter (D)	NY
26. Brian Higgins (D)	NY
27. Chris Collins (R)	NY
1. G. K. Butterfield (D)	NC
2. Renee Ellmers (R)	NC
3. Walter Jones (R)	NC
4. David Price (D)	NC
5. Virginia Foxx (R)	NC
6. Mark Walker (R)	NC
7. David Rouzer (R)	NC
8. Richard Hudson (R)	NC
9. Robert Pittenger (R)	NC
10. Patrick McHenry (R)	NC
11. Mark Meadows (R)	NC
12. Alma Adams (D)	NC
13. George Holding (R)	NC
At-large. Kevin Cramer (R)	ND
1. Steve Chabot (R)	OH
2. Brad Wenstrup (R)	OH
3. Joyce Beatty (D)	OH
4. Jim Jordan (R)	OH
5. Bob Latta (R)	OH
6. Bill Johnson (R)	OH
7. Bob Gibbs (R)	OH
8. John Boehner (R)	OH
9. Marcy Kaptur (D)	OH
10. Mike Turner (R)	OH
11. Marcia Fudge (D)	OH
12. Pat Tiberi (R)	OH
13. Tim Ryan (D)	OH
14. David Joyce (R)	OH
15. Steve Stivers (R)	OH
16. Jim Renacci (R)	OH
1. Jim Bridenstine (R)	OK
2. Markwayne Mullin (R)	OK
3. Frank Lucas (R)	OK
4. Tom Cole (R)	OK
5. Steve Russell (R)	OK
1. Suzanne Bonamici (D)	OR
2. Greg Walden (R)	OR
3. Earl Blumenauer (D)	OR
4. Peter DeFazio (D)	OR
5. Kurt Schrader (D)	OR
1. Bob Brady (D)	PA
2. Chaka Fattah (D) PA
3. Mike Kelly (R)	PA
4. Scott Perry (R)	PA
5. Glenn Thompson (R)	PA
6. Ryan Costello (R)	PA
7. Pat Meehan (R)	PA
8. Mike Fitzpatrick (R)	PA
9. Bill Shuster (R)	PA
10. Tom Marino (R)	PA
11. Lou Barletta (R)	PA
12. Keith Rothfus (R)	PA
13. Brendan Boyle (D)	PA
14. Michael Doyle (D)	PA
15. Charles Dent (R)	PA
16. Joe Pitts (R)	PA
17. Matt Cartwright (D)	PA
18. Tim Murphy (R)	PA
1. David Cicilline (D)	RI
2. James Langevin (D)	RI
1. Mark Sanford (R)	SC
2. Joe Wilson (R)	SC
3. Jeff Duncan (R)	SC
4. Trey Gowdy (R)	SC
5. Mick Mulvaney (R)	SC
6. Jim Clyburn (D)	SC
7. Tom Rice (R)	SC
At-large. Kristi Noem (R)	SD
1. Phil Roe (R)	TN
2. Jimmy Duncan (R)	TN
3. Chuck Fleischmann (R)	TN
4. Scott DesJarlais (R)	TN
5. Jim Cooper (D)	TN
6. Diane Black (R)	TN
7. Marsha Blackburn (R)	TN
8. Stephen Fincher (R)	TN
9. Steve Cohen (D)	TN
1. Louie Gohmert (R)	TX
2. Ted Poe (R)	TX
3. Sam Johnson (R)	TX
4. John Ratcliffe (R)	TX
5. Jeb Hensarling (R)	TX
6. Joe Barton (R)	TX
7. John Culberson (R)	TX
8. Kevin Brady (R)	TX
9. Al Green (D)	TX
10. Michael McCaul (R)	TX
11. Mike Conaway (R)	TX
12. Kay Granger (R)	TX
13. Mac Thornberry (R)	TX
14. Randy Weber (R)	TX
15. Ruben Hinojosa (D)	TX
16. Beto O'Rourke (D)	TX
17. Bill Flores (R)	TX
18. Sheila Jackson Lee (D)	TX
19. Randy Neugebauer (R)	TX
20. Joaquin Castro (D)	TX
21. Lamar Smith (R)	TX
22. Pete Olson (R)	TX
23. Will Hurd (R)	TX
24. Kenny Marchant (R)	TX
25. Roger Williams (R)	TX
26. Michael Burgess (R)	TX
27. Blake Farenthold (R)	TX
28. Henry Cuellar (D)	TX
29. Gene Green (D)	TX
30. Eddie Bernice Johnson (D)	TX
31. John Carter (R)	TX
32. Pete Sessions (R)	TX
33. Marc Veasey (D)	TX
34. Filemon Vela (D)	TX
35. Lloyd Doggett (D)	TX
36. Brian Babin (R)	TX
1. Rob Bishop (R)	UT
2. Chris Stewart (R)	UT
3. Jason Chaffetz (R)	UT
4. Mia Love (R)	UT
At-large. Peter Welch (D)	VT
1. Rob Wittman (R)	VA
2. Scott Rigell (R)	VA
3. Bobby Scott (D)	VA
4. Randy Forbes (R)	VA
5. Robert Hurt (R)	VA
6. Bob Goodlatte (R)	VA
7. Dave Brat (R)	VA
8. Don Beyer (D)	VA
9. Morgan Griffith (R)	VA
10. Barbara Comstock (R)	VA
11. Gerry Connolly (D)	VA
1. Suzan DelBene (D)	WA
2. Rick Larsen (D)	WA
3. Jaime Herrera Beutler (R)	WA
4. Dan Newhouse (R)	WA
5. Cathy McMorris Rodgers (R)	WA
6. Derek Kilmer (D)	WA
7. Jim McDermott (D)	WA
8. Dave Reichert (R)	WA
9. Adam Smith (D)	WA
10. Dennis Heck (D)	WA
1. David McKinley (R)	WV
2. Alex Mooney (R)	WV
3. Evan Jenkins (R)	WV
1. Paul Ryan (R)	WI
2. Mark Pocan (D)	WI
3. Ron Kind (D)	WI
4. Gwen Moore (D)	WI
5. Jim Sensenbrenner (R)	WI
6. Glenn Grothman (R)	WI
7. Sean Duffy (R)	WI
8. Reid Ribble (R)	WI
At-large. Cynthia Lummis (R)	WY